111111111111111111111111111111111111111
100000000000000C00000C00000000000000001
1E0001010010000010100100000000000000001
1P0000000C00C00000000000010010010100101
101001001010101000100100000000111000001
101001010010000010100100000000101100001
101001001010101000100100000000100000001
100000000C00C00000000000000000111100101
111111111111111111111111111111111111111