1111111111111111111111111111111111111111
100000000000001C00000C000000000000000001
1010010100100000101001000E000C0000101001
1010010010101010001001000000010100000001
1P0000000C00C0000000000000000001C1000001
1010010010101010001001000000010100000001
1010010010101010001001000000010100000001
1010010010101010001001000000010100000001
1111111111111111111111111111111111111111