1111111111111
10110000001C1
1110P11010001
1C101101E0001
1111111111111