111111111111111111111111111111111111111
1E10000C0000000C00000C00000000000000001
11100101001000001010010000000C000010101
101001001010101000100100000001010000001
1P0000000C00C0000000000000000000C000001
111111111111111111111111111111111111111