1111111111111
1001000Z000C1
1000011111001
1P001100E0001
1111111111111