1111111111111111111111
1101000010100001000001
100C011000001000101011
10101100E0001CP0101011
1111111111111111111111