11111111111111111
110100000010000C1
100C0111100010001
10101100E0001CP01
11111111111111111