1111111111111
10010000000C1
10000111110011
1P001100E0001
1111111111111