1111111111111
10010000000C0
1000011111001
1P001100E0001
1111111111111