1111111111111
100100E00E0C1
1000E11111001
1P001100E0001
1111111111111