NO ./srcs/texture/feu.xpm
SO ./srcs/texture/bois.xpm
WE ./srcs/texture/brick1.xpm
EA ./srcs/texture/brick.xpm

F 64,64,64                                                                       
C 20,20,50 






1001000000001000000000001
1111111110110000011111111
1000E00000110000011111111
1111011111111101110000001
1111011111111101110101001
1111111111111111111111111