1111111111111
10010000000C1
1000011111001
10001100E0001
1111111111111