1111111111111
100100000P0C1
100001111P001
1P001100E0001
1111111111111